#@########
#.##..####
#.###.####
#.###.####
#.#...####
#.......##
#.##.....#
#.######.#
#........x
##########